B                  B
B                  B
B                  B
B                  B
B                  B
B                  B
B                  B
B                  B
B     D            B
B     D            B
B    BB            B
B   B       BBB    B
B                  B
BBB               BB
B                  B
BBBBBBBBBBBBBBBBBBBB
